1111111111111
101CC01P0CCC1
10110C101E1C1
1CCCC00C1CCC1
1111111111111