111111111
111111111
101P01E11
10000C001
101001001
111111111
111111111