11111100000011111
10000000000000001
10000011111000001
1000000000000PCE1
11111000001111110