11111111111111
1001110000E00001
1111CCCCP00001
11111111111111