11111111111111
111111P1111111
111110E0111111
111111C1111111
11111111111111