11111111111111
11111100P01111
11111C0101E111
11111111111111