11111111111111
11111101111111
11111PEC111111
11111101111111
11111111111111