11111111111
1SADAVNKDF1
100P0PC0E01
11111111111